-------G
-W---W--
--WW----
-F--E---
-FW-----
-F-W-W--
--EW----
S-------
