-------G
--E-----
-3------
-3-3----
-3-3--F-
---FF3--
-E-F----
S-------
