-------G
-E------
--F-3---
--3F3-3-
-E------
--3F--F-
----3---
S-------
