-------G
-WWW----
---WEW--
-W-FWW--
--EF----
--------
--------
S-------
