-------G
-W--WFW-
-WF-----
--F-----
--------
----WWF-
-W------
S-------
