-------G
---E-33-
-F---3--
----E---
--3-F3F-
-33---3-
--F--F--
S-------
