-------G
-W--W---
-----W--
---WFEW-
-----W--
----W---
-----W--
S-------
