-------G
---3F3--
---EF-3-
----3-E-
---E33--
--F-----
---3----
S-------
