-------G
-3----3-
-E3--3--
-3---3E-
-E-3--F-
--F--F3-
-F---3--
S-------
