-------G
--------
--E3----
---F--3-
---33---
-F3--3E-
---3-3--
S-------
