-------G
-W----W-
-EW--W--
-W---WE-
-E-W--F-
--F--FW-
-F---W--
S-------
