-------G
--F-W---
-F------
-EW-W-E-
--------
--FF-WW-
-E--F-W-
S-------
