-------G
----F-3-
--------
-3------
----33--
--------
3----33-
S3------
