-------G
----W---
-E------
---W-F--
---FW---
-F------
--W--W--
S-------
