---F---G
-W--WFW-
-WF-----
--F-----
--------
----WWF-
WW------
SW------
