-------G
----WWW-
-----F--
----F-W-
--WEE-F-
--W-----
--------
S-------
