-------G
-W------
--W-W-F-
-EE-----
--W---F-
--F-----
-FW-----
S-------
