-------G
------W-
---W--W-
-F-WF---
---W----
-F---FE-
-WEE--W-
S-------
