-------G
-3-3----
-3-333--
-FF-----
------E-
--------
-----33-
S-------
