-------G
--------
--3-33--
----3-3-
--------
--FF----
-----3--
S-------
