-------G
---3--F-
--33--3-
--------
-E------
---3-3--
----33--
S-------
