-------G
--F-----
-3E3----
-3-F----
-3F-FE--
-E-3----
----F---
S-------
