-------G
----3E3-
----33--
--------
-F33-3--
----3---
----3---
S-------
