-------G
-33-E-F-
-----E--
--------
-3--3-3-
---33---
----3---
S-------
