-------G
--3-----
---F----
-----3--
--3E3-E-
----3FF-
--------
S-------
