-------G
--33--F-
-3E-----
--------
---3----
---3-3--
---F3---
S-------
