-------G
-3-E--3-
--3--E--
---3-F--
-----3--
----3-E-
----333-
S-------
