-------G
--------
----3---
--33--3-
---3----
----FE--
-3F---3-
S-------
