-------G
--3--33-
------3-
------E-
-3-F--F-
---F----
--3-3-F-
S-------
