-------G
-----3--
-EF-----
-F-3F-3-
-F------
--E---3-
-3--F---
S-------
