-------G
--3-----
-3-3--F-
--EF-3--
-3------
----3E--
-3--3---
S-------
