-------G
-E--F---
---33E3-
-F3-3E--
-3--F3--
---3-F--
-3-F----
S-------
