-------G
-EF-----
-----33-
-----3--
-3------
--EE----
-F--F3--
S-------
