-------G
--E-----
-F3---F-
---333--
------3-
--F-----
-3E-----
S-------
