-------G
---3----
--3---3-
----F-3-
-----E--
----3-E-
--3-----
S-------
