-------G
--3-----
--E---3-
----F3--
-F-333F-
---F-F3-
--------
S-------
