-------G
----3---
--------
-3------
--3---3-
-3F3-3--
-3E-----
S-------
