-------G
-F-3-3--
---F----
--3F-FF-
--3-----
-33--3--
--3-----
S-------
