-------G
----E-3-
------3-
--3--33-
--3--E--
-E-F----
-F3-----
S-------
