-------G
--33----
-E------
--33----
-3--33--
-----F--
-E3-----
S-------
