-------G
--FF3-F-
--3EF3--
------3-
--3-----
-3--3---
--------
S-------
