-------G
-----3--
-E-E----
---3--3-
-----3--
--E33F3-
---3----
S-------
