-------G
---F----
-----3--
-F----3-
--3--E--
-3F-----
------3-
S-------
