-------G
-3-E-3--
--F--3--
---FF-3-
----FE--
--3-3-3-
-----E--
S-------
