-------G
------3-
--333---
--------
---F-3--
-3-3--F-
-3------
S-------
