-------G
----3E3-
---E--3-
--------
----3---
--3-3-3-
-----EF-
S-------
