-------G
-----E--
----3---
-E------
--3F-3--
-3-33-3-
-F3---F-
S-------
