-------G
-FF-----
--F3-3--
-----3--
--------
-EF33---
-F-3----
S-------
