-------G
----F3--
--3F--3-
----3-3-
----3---
-EF3--F-
----F-3-
S-------
