-------G
-3------
---E-E--
-----E--
---333--
-----F--
-3--3---
S-------
