-------G
--3---3-
-----3--
-----3--
-----3--
--------
---F33--
S-------
