-------G
---F--F-
---E----
-----3--
-F----3-
--3-3---
----3F--
S-------
