-------G
---3----
----F-F-
-3E3-3--
---3-3--
--EF----
-3------
S-------
