-------G
-3----F-
--3-----
---F----
----33--
-F--3---
---3----
S-------
