-------G
-----E--
-----3--
-33--3--
--E3----
----3---
---3-3F-
S-------
