-------G
-333----
---E----
-3--3---
-F3-F---
-3----3-
---FE---
S-------
