-------G
-3----3-
---F3---
--------
-E3EFE--
-----3--
-3-3----
S-------
