-------G
-F----3-
-33E----
------F-
--3E3---
--------
-F-33-F-
S-------
