-------G
--------
-3--3---
--F--3--
-33-----
-3E---F-
---F3-3-
S-------
