-------G
-F-F----
--E3-3--
--F--E--
--3---F-
-33E3---
--3--3--
S-------
