-------G
---F----
--------
--33F3--
-F--3---
--3-3---
------3-
S-------
