-------G
------3-
-3---3--
-E------
--F--F3-
-F--3E--
---E----
S-------
