-------G
-----3--
-----3--
-3------
--33-3--
----FF--
-3FF----
S-------
