-------G
---FF-3-
--3-----
-3-3-3F-
-3------
--3-----
--------
S-------
