-------G
------3-
----F---
------3-
-----3F-
-----3--
-333--F-
S-------
