-------G
-F-F-3E-
-F------
----3-3-
-F------
-----3--
-E----3-
S-------
