-------G
-F---F--
-----3--
--------
--E---F-
-33---3-
--3-----
S-------
