-------G
-3F-----
--------
--F-----
--33-F3-
-3---3F-
------F-
S-------
