-------G
--3-F---
------3-
----3---
----33--
--33F---
--F-3---
S-------
