-------G
-----3--
--E-----
--------
--3-----
--333---
------F-
S-------
