-------G
--FE----
-3-33---
------E-
---F----
-F-33---
--3--3--
S-------
