-------G
----3---
---F----
---3333-
--F---3-
-F------
-3---FF-
S-------
