-------G
-33---3-
-3-3----
------F-
----F---
-3---3--
--3-E---
S-------
