-------G
-----3--
-----3--
---333--
-----33-
-E----3-
----F-3-
S-------
