-------G
-E-E3-3-
--------
------E-
-F---3--
-F-3-F--
-FF3----
S-------
