-------G
--33----
--------
-3----3-
-F------
---F-F3-
------F-
S-------
