-------G
-3-33---
--------
-E------
---3----
---E--3-
-F---3F-
S-------
