-------G
------F-
--------
-FF-----
-33-F3--
---3-F3-
-33---3-
S-------
