-------G
-F------
-3-33---
-E------
----E-F-
-33-----
---3-3--
S-------
