-------G
--3-3F--
---E3---
--3---F-
---E----
----3F--
-3------
S-------
