-------G
--3---3-
--------
----FF--
------F-
---3-F3-
--3-----
S-------
