-------G
-F---3--
------E-
-F3--3--
--------
---F-E3-
-3F-F---
S-------
