-------G
-3-3-33-
--F3----
---33---
-FFE--F-
------3-
--F3----
S-------
