-------G
--------
-3------
-E3-E-3-
--3--3F-
---E----
-F----F-
S-------
