-------G
----33--
-EFF----
-3-3----
-F3-E---
-3---F--
-F------
S-------
