-------G
--E--FF-
-33-----
--3-----
-3------
---33---
---3----
S-------
