-------G
---3----
--------
-----F3-
-----33-
--------
-3---3--
S-------
