-------G
--------
--F-----
--3--3E-
---EE---
---3F-3-
--3--3--
S-------
