-------G
--3-----
-33---F-
---F--3-
-E---33-
--------
-33-3---
S-------
