-------G
-3------
-F3-F-3-
--3-E---
--F--F--
-F------
--3--3--
S-------
