-------G
-E3--3--
--3-3---
--------
---F3F--
-3---3--
-3--3---
S-------
