-------G
---3E---
--F3E---
--E-----
----3-3-
------3-
-3------
S-------
