-------G
----3E3-
--F-F3--
---3-3--
--33----
------3-
-F------
S-------
