-------G
--E3----
--------
-----3--
-3E-----
-3-EF-3-
-3-F----
S-------
