-------G
---3----
----E---
-3-3-F3-
-3------
-E-3----
-3-3FE--
S-------
