-------G
-3-F----
-3-F----
-----33-
----E---
-3E-F3E-
-3----3-
S-------
