-------G
----33--
-3-3F-3-
--------
--------
-----E--
--3-----
S-------
