-------G
---3-33-
-----EF-
------F-
-----F--
-3-E----
-----3--
S-------
