-------G
-E-E----
--------
-3------
-33-----
--33-3--
-F-3E---
S-------
