-------G
-F--3F--
--E33---
--------
-3---33-
-F------
---F----
S-------
