-------G
---33---
--F--3E-
-33-----
--33----
--------
------E-
S-------
