-------G
-3------
---F--F-
-----33-
-3--3F--
-3--FF--
-3-3----
S-------
