-------G
-----3--
-33-----
--3-----
---3--3-
-----F3-
------3-
S-------
