-------G
-33-F-F-
-3F-----
--3EF---
-----E--
----33F-
--3-----
S-------
