-------G
-3-3F-E-
--F33-3-
---3----
-E---3--
--------
--F-E-3-
S-------
