-------G
-----F--
-F-EF3--
---33---
--F3-FE-
---3-E--
-33-3---
S-------
