-------G
-F3FE3--
--------
---33---
--F---3-
-----3--
--------
S-------
