-------G
------3-
-----3--
--------
--E3F3--
--3--3--
------3-
S-------
