-------G
-----E--
-3E--F--
-F--3-3-
--3-E---
--3-----
--------
S-------
