-------G
-F-E3---
-33-----
---3F---
--------
---3----
-----3E-
S-------
