-------G
--3--F--
------3-
-F--33--
-33--FF-
----F---
--------
S-------
