-------G
-3--3---
-33--3--
----3-3-
-E------
-F-3----
---E----
S-------
