-------G
--3---3-
-----E--
-3F--3--
----F---
----E---
-E3-----
S-------
