-------G
-3------
------F-
---3----
--33-3--
--3-3---
-3--3---
S-------
