-------G
---3----
-3-3----
-F3E3F3-
---3----
-F----E-
-3--F-3-
S-------
