-------G
------E-
----FE--
-333--3-
-3-F----
--3-----
-3-3-3--
S-------
