-------G
--------
--3-----
-E3---F-
-----33-
-----F--
-333----
S-------
