-------G
-3---E3-
--3--FF-
--E---3-
----33--
--E-F---
--3-F33-
S-------
