-------G
--33----
--------
--3-3-3-
-3-3-E--
--3---3-
--FF-F--
S-------
