-------G
--------
----3F--
------3-
-FF3-E--
-----3--
---3FF--
S-------
