-------G
----E33-
----E-3-
-F------
------3-
--3-33--
-E---3--
S-------
