-------G
-3-3----
---F--3-
---3----
-----3--
-F------
--------
S-------
