-------G
---3----
-3---F--
---F-3--
--------
--3F-EF-
--3--F--
S-------
