-------G
-E-3--F-
---F-E--
--E--F--
--------
-3--3-3-
-3--3-3-
S-------
