-------G
------3-
----E3F-
-33-E3--
--3-33F-
--------
--------
S-------
