-------G
--------
--3---F-
---3-3--
---F----
-33--E--
---3333-
S-------
