-------G
-E33F---
--F---3-
--------
-33-3-F-
--F-3---
--------
S-------
