-------G
---FF3--
-E-F----
--3E----
---3-F--
-33--3--
---33---
S-------
