-------G
----3-3-
-3---FF-
-F33----
-----3F-
------3-
-E---3--
S-------
