-------G
-F-E--F-
----3-3-
---3E-F-
--F---F-
---33-3-
--------
S-------
