-------G
-3FE-FF-
------3-
----3-E-
------E-
-F---33-
---F----
S-------
