-------G
-3-F-33-
---EF---
---E--3-
--3--E3-
-F-3----
-F---F--
S-------
