-------G
-33--F--
--3-3E--
------3-
---F----
--33-3--
----F---
S-------
