-------G
---3-F--
---F----
----3---
-F----F-
-3-3--3-
-----33-
S-------
