-------G
---3----
--------
---33---
---E--3-
--3-----
--E--F3-
S-------
