-------G
--------
-----E--
---3333-
--3-33--
---3----
----3F--
S-------
