-------G
-E-3----
-----3--
-F---F--
---F--3-
--3---3-
------3-
S-------
