-------G
-3E-----
--------
----333-
-----33-
--E3-E--
----3F--
S-------
