-------G
------3-
--------
--33F-3-
-3EF3---
--3-E-3-
--E-3---
S-------
