-------G
---3--F-
------F-
-----3F-
--3-----
---F-3--
--3-33F-
S-------
