-------G
--------
--3-E---
---E-3F-
---F-3--
--3-3-3-
-3--33E-
S-------
