-------G
-F--F-3-
-3----3-
---3----
--FE----
---3----
------3-
S-------
