-------G
---333--
-33-----
--33F---
---F----
----E3--
-3--EF--
S-------
