-------G
---3----
-3-3--3-
----3---
-----3--
---E----
-F----E-
S-------
