-------G
--------
--------
-3--333-
---F3---
-3---3--
-3----3-
S-------
