-------G
------3-
----3---
---3-3--
-3EF----
--------
----33--
S-------
