-------G
----3-3-
----3---
-333-3--
---F-3F-
--------
---FF---
S-------
