-------G
----3---
--F-----
-3----E-
---3--F-
--F--F--
-3E-3-3-
S-------
