-------G
-3F3-E--
--E-----
---33---
--------
----3-3-
---3----
S-------
