-------G
-3---F3-
---3----
--F3----
---F-E--
-F----3-
-33--33-
S-------
