-------G
------3-
-----3--
--------
-3--3EF-
-3------
----E-3-
S-------
