-------G
--------
--3-F---
--------
----33--
------3-
----3---
S-------
