-------G
------F-
----3---
-3-F----
-3-33---
--3--E3-
--3-3---
S-------
