-------G
------E-
---3-E3-
---33E--
-F------
-333----
------3-
S-------
