-------G
-----F--
--------
----3---
-33FE---
---33---
-3-FF---
S-------
