-------G
--FF3-3-
--3---E-
--3--3--
--33----
-F3-----
-E3-E---
S-------
