-------G
--------
--F-3---
-F----3-
--333---
-F3--3--
---3-3--
S-------
