-------G
-33-----
-3F3--3-
--F-----
-FF-F---
-----3--
--------
S-------
