-------G
--E-F3F-
-----3F-
--EEF-3-
--3-----
--3-----
-----3--
S-------
