-------G
----3---
-3------
----3E--
--3---3-
--F-E3--
--------
S-------
