-------G
--3-----
-33F--F-
-F--F-3-
--------
-----3E-
-F----3-
S-------
