-------G
-----3F-
----F---
--3---3-
----33F-
--------
----3---
S-------
