-------G
--------
----3---
--------
--333F--
---33---
----3---
S-------
