-------G
--------
-----33-
-F-3--3-
-----33-
-3-3--3-
---E----
S-------
