-------G
--3-----
-F-3-3--
-----3--
--3-----
-3F-----
--33----
S-------
