-------G
---FF---
--3--3--
---E----
--------
-E33----
----3---
S-------
