-------G
-F3-----
-E3-----
-FF3-33-
--3-----
------F-
------3-
S-------
