-------G
---3----
-----3--
-3--3E--
---3FE--
-F--3-3-
---3-3--
S-------
