-------G
--3-----
-333----
---F----
-F-3----
-E----F-
--------
S-------
