-------G
-----3--
--------
---3----
---3----
----3---
-3-F-F--
S-------
