-------G
---3----
--3F-3--
--------
--3-F3--
---F----
--------
S-------
