-------G
-----3--
---33---
----3---
-3------
-----E--
-FFE----
S-------
