-------G
-3---F--
------3-
--3---F-
--3E3EE-
--F3--F-
-F------
S-------
