-------G
-3------
-F------
--------
--FF3-3-
--3-----
-3E3-F--
S-------
