-------G
--------
-3-F----
-E-3----
---3----
-3FE-F3-
---333E-
S-------
