-------G
-3---33-
--F3-3E-
------3-
--3-3---
---FF---
--3--F--
S-------
