-------G
--------
-3F-----
-E--F---
--------
-3--33--
-3--3-3-
S-------
