-------G
---3----
---3-3F-
----33--
--3--E--
--3--3--
--------
S-------
