-------G
--3F----
--------
----33E-
--E---F-
--EF3-3-
---3-33-
S-------
