-------G
-3---3F-
-F3-E-3-
-EF--3--
--------
------3-
--3-3-3-
S-------
