-------G
--E-E3--
-----E--
---3--3-
-----3--
-3----F-
-FF-----
S-------
