-------G
--E33---
-----3--
--EF--F-
-E3-3-3-
-F-33---
-F3-----
S-------
