-------G
------3-
--3-----
--------
--3-----
--3-----
----3F--
S-------
