-------G
-E------
---E--F-
-3-3--3-
-F3-----
---E-F--
---3----
S-------
