-------G
---33---
-333-E--
--E-3-3-
-F------
--------
--3E----
S-------
