-------G
--3F----
--E--33-
---3--3-
--------
--E---3-
--------
S-------
