-------G
--F---F-
-3------
-3---3--
--3-3---
-F33----
------3-
S-------
