-------G
---F-F--
-E---3--
-----3--
-F-3----
---E--3-
--3E----
S-------
