-------G
--F-3-E-
-3------
--E-F-3-
------3-
---33F--
----3---
S-------
