-------G
-E-3EE--
----3---
-3------
--F---3-
-3---3--
---F----
S-------
