-------G
-F-3E---
--3-----
-E-3----
-3--E---
---F----
--F-33--
S-------
