-------G
-----F--
--3--3--
---33F--
---3-33-
--F-F---
--------
S-------
