-------G
------F-
--FF----
-----E--
-33F3---
--E--3--
-E3---3-
S-------
