-------G
---3F3--
----3-3-
-33F----
-3----3-
--------
----E---
S-------
