-------G
--3-3---
-F--3---
-3---F--
--F33---
-F3--E--
-----33-
S-------
