-------G
----333-
-3------
--F-----
-F------
--F--3F-
---F----
S-------
