-------G
---333--
--E-----
----F---
--3F----
-3----3-
---3----
S-------
