-------G
--F-3-E-
--------
-----F--
-E---3--
---3--3-
----3---
S-------
