-------G
---3-F--
--E--F--
--3-3F--
-3EE-3--
----F---
---3-F--
S-------
