-------G
---3E3--
--3-33F-
----F---
--F--3--
-3--3F--
------3-
S-------
