-------G
--F--3--
-F33----
-F------
--------
-F--3---
-3------
S-------
