-------G
----F---
-E-333F-
--3-3F3-
----3E--
--E-----
-F-F----
S-------
