-------G
--F-F---
---3----
----F---
--3-F-F-
-33--3--
--------
S-------
