-------G
-F---33-
-33--E3-
-----33-
--------
-F---3E-
-----3F-
S-------
