-------G
-FF-----
---33-3-
-F------
--F-3-3-
----F---
-----3--
S-------
