-------G
-----F--
-3------
--E-E---
---F33--
--33--3-
---F----
S-------
