-------G
------E-
-33---F-
---3-3--
-3---3--
----3-E-
--E-----
S-------
