-------G
---F-FE-
---3-F--
-3E-----
-3-3----
------3-
----3E--
S-------
