-------G
--3-----
----3-F-
----33--
-3--3E3-
-F3-----
-E-3----
S-------
