-------G
-3------
---F----
--------
-F3-----
-3F--33-
--3--3--
S-------
