-------G
----3-3-
--------
---3F3--
----33--
--3-----
---3-3--
S-------
