-------G
-F------
---E--F-
--33--3-
-FE--E3-
--3---3-
---3F-3-
S-------
