-------G
----F3--
----33E-
-F------
--3--EE-
--------
-3--F3--
S-------
