-------G
------F-
--------
------E-
----F---
--3--33-
--33----
S-------
