-------G
---3-3--
--F-3---
-F3-3---
-3----F-
--3-F33-
--E---F-
S-------
