-------G
-F------
-F----F-
-3---3--
-E------
-333EF--
-E3-----
S-------
