-------G
--E---3-
---3-3--
---3E3--
-F----E-
--3---F-
--3-----
S-------
