-------G
------3-
---3----
-3-3----
---3-F--
--------
-----33-
S-------
