-------G
--F3--3-
----3---
-----3--
-----33-
--3---3-
----3F--
S-------
