-------G
----3FF-
--------
-3--E---
--F-E---
---3----
-3FF3---
S-------
