-------G
-EFF-E--
----3F--
---3----
----E-3-
--3-3---
--F-F3--
S-------
