-------G
---3----
--3-FE--
--FF-3--
--------
--E3EFF-
---3----
S-------
