-------G
---3----
--E-----
-----3--
------3-
-3-3----
---F33--
S-------
