-------G
--3-----
-33--3F-
--E---F-
-3-F----
-----3--
---FE---
S-------
