-------G
--3-----
--F--E--
-33---F-
-----F--
--3-F-3-
----3E--
S-------
