-------G
-----E--
--3-----
--------
-3-333--
-FE-----
--------
S-------
