-------G
-3-FF---
------3-
-F------
-3F--3--
--F33-3-
---E----
S-------
