-------G
-----3--
-EE-----
---33---
-3-FF-F-
-3-FF-E-
--------
S-------
