-------G
-F3--3--
----F---
-3F---E-
----E-3-
------3-
-----3--
S-------
