-------G
-3EF----
----3-3-
--F3----
--------
--3--EE-
--------
S-------
