-------G
--F--F--
-F-3333-
--3F----
--E-----
---E-E--
-F33----
S-------
