-------G
-E3-3-F-
-E----3-
-3----3-
----F---
-F3---F-
--3--E--
S-------
