-------G
----E-F-
-FF-----
-3F--33-
----3---
--F3E---
-3E-----
S-------
