-------G
--F-3---
----3---
-3F-E3--
-F--33--
--------
------3-
S-------
