-------G
--F-3---
--3-----
---3F-F-
--------
--------
-33-----
S-------
