-------G
----E-3-
-3---3--
-3---3--
--3---3-
-----FF-
-3------
S-------
