-------G
-----3F-
--------
--3---3-
-F----3-
---F----
-3F--3--
S-------
