-------G
--------
-E--3---
---3----
-FF3----
-3-3----
-3--E-E-
S-------
