-------G
-----3--
-3------
-----FF-
-33-F3E-
---3----
----EFF-
S-------
