-------G
------F-
----33--
-F---F--
-33-33F-
--3-3---
-3------
S-------
