-------G
--3-----
---3-EE-
-3---3--
--3333E-
-----F--
---3----
S-------
