-------G
---E-3--
--F3-E--
----3F3-
--F3--3-
---F--3-
--3-E-F-
S-------
