-------G
--------
----3---
-E--3---
-333-E3-
----3-F-
---3E-3-
S-------
