-------G
-E---F--
-3F3-F--
--3--3--
---3----
-33-----
--3F--F-
S-------
