-------G
---E-33-
--------
----E---
---3-3--
-F-3-3--
-----F--
S-------
