-------G
--33F---
--3F--3-
-3-3----
---F----
-F--3E--
---3--3-
S-------
