-------G
------3-
-F-3F---
-3-E----
--F3-E3-
-EF3----
--3-----
S-------
