-------G
-----3--
--------
----3---
-33-3-F-
--E--F3-
-3------
S-------
