-------G
--3F----
-E3---F-
-F333---
-3E---F-
----E---
----33--
S-------
