-------G
----33--
--------
--3-F---
-F------
-----3--
---3-3--
S-------
