-------G
-----F3-
-3-3--3-
-----E--
----E---
-----3--
--E-----
S-------
