-------G
-E-F-3--
---E-33-
----3---
---3----
-----F3-
---333--
S-------
