-------G
-----3--
----FF--
---F33E-
-----FE-
---FE---
-33-333-
S-------
