-------G
----E-3-
--F--3--
-E3---3-
----3F--
-333----
---EF-F-
S-------
