-------G
--3-----
---F----
--3-----
--------
--F3-33-
-33---E-
S-------
