-------G
-3---3--
---F----
--------
-3-333--
------3-
--------
S-------
