-------G
--3--33-
-E---3--
-FF-F---
---F----
--EE--3-
------F-
S-------
