-------G
-----3--
---F----
--E-----
--3-3F3-
-F-3----
-3------
S-------
