-------G
--E3--F-
--F-----
---3--3-
------F-
----333-
---F33F-
S-------
