-------G
------3-
-3-3F-3-
--3F----
--------
-3---EE-
--------
S-------
