-------G
-3------
--3E----
-3-F-3--
--3---3-
---EE---
----FF--
S-------
