-------G
----F3F-
--------
-F----3-
----F---
----3-3-
----3F--
S-------
