-------G
---3----
--------
--E--3--
-F33F---
-F------
-3FE----
S-------
