-------G
---3--3-
-33-----
--------
-F------
-FF3----
-3--F---
S-------
