-------G
--F-F---
--3F3-E-
---3--3-
-F--EFE-
--------
-----3--
S-------
