-------G
-----33-
---F-3--
-F----F-
--------
---F--F-
-33---3-
S-------
