-------G
--F--F--
-3-FE---
----3---
--3--E--
-3-33---
-F3F3-3-
S-------
