-------G
-3FF3---
----3-3-
--------
---F----
-----3--
--------
S-------
