-------G
-----F--
---E-33-
-----E--
---3--3-
-----E3-
--F3----
S-------
