-------G
----3---
--3-----
--E-33--
--------
---F3---
----F---
S-------
