-------G
---3----
-F3-----
-F---33-
--------
--------
---3-EF-
S-------
