-------G
--333-F-
-3-E-3--
-E------
-F-33FE-
---3----
-3------
S-------
