-------G
--3-----
-----F--
------F-
-3-33-F-
-F-3----
-3------
S-------
