-------G
---3--3-
---3F-3-
------3-
--------
---F--F-
----F-3-
S-------
