-------G
-3---33-
-EE-----
----33--
----F3--
-----F--
--3---3-
S-------
