-------G
--3FF---
----F-F-
-33E----
-33F3---
-3-3----
--------
S-------
