-------G
-3----E-
----F---
-F3-E---
-F-EF33-
----3F--
--3-----
S-------
