-------G
--3-F-3-
-3------
-3FF-FF-
-----3--
--------
--------
S-------
