-------G
-F-3----
--3-3---
-----33-
-----3--
--F-----
--E---3-
S-------
