-------G
--33----
-----3--
----3FE-
-3--3---
---3----
-F---F3-
S-------
