-------G
--3---3-
-F-FF3--
--------
-F------
------E-
---33F3-
S-------
