-------G
--F--E--
-3--FF3-
-3----F-
-F------
-3-3--3-
--3-E3--
S-------
