-------G
--3--3--
-E3-F---
--3-F---
--F3----
-E------
--------
S-------
