-------G
-3---3--
--E-333-
----3E--
----3-3-
----FE--
-----3--
S-------
