-------G
-3-F--E-
------3-
---F3---
--------
--3-3E--
---F----
S-------
