-------G
------3-
--------
--F-----
-33-----
-3E-----
-F3---F-
S-------
