-------G
--3F----
--3-3---
--E-----
---E----
----E-3-
-F----3-
S-------
