-------G
--------
-----33-
---E-3--
----F---
-3E3-3--
--3-----
S-------
