-------G
----F3--
-3FF----
-3--F-3-
-33-----
--3E--3-
---3----
S-------
