-------G
-F--F---
-----3--
-3---E--
-3------
-3-E--3-
-3F---F-
S-------
