-------G
--33-3--
--3-----
-33--F--
---3--3-
--3-----
-F-FE-F-
S-------
