-------G
--33----
----F---
-----F--
--33----
--F--3--
--------
S-------
