-------G
--3-----
-E33----
--F-333-
----E---
-3FFE---
-33-F---
S-------
