-------G
--333-3-
----3---
--------
-F-F-3--
-E3-----
--33----
S-------
