-------G
-3--F---
----3---
-----3--
-3------
---333--
------F-
S-------
