-------G
-3E---3-
---33---
--E--F3-
----3---
--F-333-
-----E--
S-------
