-------G
-3--E-F-
-EF3--F-
-3--F-E-
--------
---3----
-3-3F33-
S-------
