-------G
-----3--
-E--E3--
-----3--
--F---E-
----F---
--3--3--
S-------
