-------G
--3E----
--33FF--
-33-3---
--F3-F--
--3---3-
--F---E-
S-------
