-------G
--------
--------
----33--
-F-F----
---3-E--
--F-33--
S-------
