-------G
-3F--3--
-F-E3-F-
-E----3-
---3E---
------3-
-----F--
S-------
