-------G
--------
---3-33-
--3-----
-3--F---
--------
------F-
S-------
