-------G
--------
-3E--E3-
---33F--
---33---
-F3-3-F-
---F--F-
S-------
