-------G
-3F3E3--
--------
--F-33--
---3----
-F--33E-
---E----
S-------
