-------G
-FF3----
---F----
----3-3-
--33-3--
-3--F-3-
----3E--
S-------
