-------G
--------
--3---F-
--3--3F-
-3-3----
---33---
-33---E-
S-------
