-------G
---3-F--
---3FF--
-FE---3-
-33-3-F-
---E----
-E3--33-
S-------
