-------G
-333----
---3F---
------3-
--------
-3------
-----3--
S-------
