-------G
-3E-----
---F-E--
-E------
-33F3-3-
--------
-33F-3--
S-------
