-------G
-3--F---
--3-----
-3F3----
---3----
-3----3-
---3----
S-------
