-------G
-3--3-3-
----E3--
-3------
-F3-----
-FFE--F-
--------
S-------
