-------G
---3----
-----F--
---333--
-----3--
---E33--
---3F3--
S-------
