-------G
----3---
--3-----
-----3--
---F-F3-
-3-FF3--
---333--
S-------
