-------G
--3-E---
----3EF-
------F-
-E--F33-
-F-333--
-F-3-3--
S-------
