-------G
--3--3--
------F-
--3--3--
--3---E-
-F3-3---
---F----
S-------
