-------G
-F3F----
---3----
-3E33E3-
-FF--3--
-F------
--3E--3-
S-------
