-------G
--33-3F-
-33---E-
--E-----
-----3--
---F3---
-----3--
S-------
