-------G
---3----
--F-F---
--E-----
-333E---
--E-----
---FFF3-
S-------
