-------G
--3-F---
-3--E-E-
---3----
------3-
-33-----
--3--33-
S-------
