-------G
--------
-F------
-E---33-
----3---
----F33-
---3----
S-------
