-------G
-3------
-3--333-
-F--3-E-
----E-F-
-----E3-
---33---
S-------
