-------G
---F-E3-
--33----
-----3--
--3333E-
-----3--
--------
S-------
