-------G
--333-3-
----FF3-
-3-3----
--------
---3E---
-EE-3-F-
S-------
