-------G
---F-E--
---F333-
-----3--
-F3E3---
-3---3--
-F3EF---
S-------
