-------G
-3-F-33-
----F---
--3F-EF-
-333--3-
--------
-E---3--
S-------
