-------G
-F3-----
--E-3---
--F3F-F-
--F33---
--E--3--
-3-3E---
S-------
