-------G
-3------
---3-3--
--3--F--
--3-----
--F3--F-
--F-33--
S-------
