-------G
-F------
--------
-33---3-
--------
----3-3-
-----3--
S-------
