-------G
-F--3---
-F----E-
-F-EF-3-
---3----
--3--3--
--E3-F--
S-------
