-------G
--------
----F---
-33E3---
-----3--
----3---
-3----3-
S-------
