-------G
-3------
---3F-3-
--3-----
-FFEE-3-
--------
-3E-F3--
S-------
