-------G
-F--F3--
--33--3-
-----3--
-3--F---
--F3----
------3-
S-------
