-------G
---3-E3-
---3----
--3---F-
--------
-----33-
----3E--
S-------
