-------G
-F-33---
---3----
----F---
--E-----
-E----3-
--F3-33-
S-------
