-------G
-----F--
--F-----
-F3---3-
-3--3---
-F---33-
-----3--
S-------
