-------G
-F---3F-
----33--
-3E-3-3-
--F-F-F-
-E-E----
-3--3---
S-------
