-------G
------F-
----3-3-
--3--3--
-3------
-EE--3--
--3-----
S-------
