-------G
--3-F-F-
----F---
--------
--3-33--
-F---F--
-3-E3---
S-------
