-------G
------3-
--------
----F3--
-3---3--
---3-3--
-3------
S-------
