-------G
-3--3---
--F3----
---33-F-
-F-3----
--FF----
---3--3-
S-------
