-------G
----F---
----F-3-
---E3F3-
---3--F-
-F-E33--
---E----
S-------
