-------G
--E-3-3-
------3-
---E----
--3FF3--
--3-----
-E--3-F-
S-------
