-------G
-E--F3--
--E-----
--------
----3---
-3-3--3-
----F---
S-------
