-------G
-3F33-3-
--3-3---
-E--EE--
-F-F-3--
----F---
-F3--3--
S-------
