-------G
-33-----
------E-
-F------
-33-----
--EFE3--
------3-
S-------
