-------G
--------
-3--E3F-
---3----
--------
-33---3-
-F---3--
S-------
