-------G
--3--F--
-3F33-3-
------F-
-E--3---
-----E--
---3-E3-
S-------
