-------G
--3--F--
-3F3----
---3----
---3-EF-
--3-----
-3------
S-------
