-------G
-----F--
---333E-
---F----
------3-
-E-3----
-E----3-
S-------
