-------G
--3-E---
-3------
-3--F---
---33-E-
--F3----
----E---
S-------
