-------G
------E-
---3FF3-
-----33-
----3---
--3--3--
-E------
S-------
