-------G
-E--3-3-
-F3--E3-
---3-3--
--------
------F-
--3-----
S-------
