-------G
-F33-3--
----3-F-
--33F-F-
-3------
----3---
--F-----
S-------
