-------G
-F3333--
------3-
---3E-3-
--------
--------
---E----
S-------
