-------G
--------
--333-F-
-3--3---
-33--F--
---33-F-
--------
S-------
