-------G
-----3--
-F3--F--
---3----
---3F---
---33EF-
-3----3-
S-------
