-------G
--F33---
-F333---
--------
---F----
-E---33-
----F3--
S-------
