-------G
---33-E-
--F--3--
--3---3-
---FFFF-
-----3--
---3----
S-------
