-------G
-3------
-----F--
--------
-3-E3---
---3----
--E--3--
S-------
