-------G
-3-33-F-
--3--F--
-3----E-
-EF3----
-E-3--F-
-3--3---
S-------
