-------G
-33EF3--
----3---
-F3--F--
-----3E-
--EF----
-3----3-
S-------
