-------G
--3-3---
--3-----
------E-
--------
---3-EF-
----3---
S-------
