-------G
----3---
-F33-E3-
----3E--
------3-
------3-
--3-3---
S-------
