-------G
-----33-
-F---3E-
--3-----
-FF-3---
-----E--
---F----
S-------
