-------G
--F--F--
--E--E3-
---33---
---3-F--
-----F--
--33----
S-------
