-------G
--------
--3-3---
----33--
-E------
-E-3--3-
-F--E---
S-------
