-------G
--F-E3--
-3---F--
---3E---
-----F3-
--F3--3-
--3--F--
S-------
