-------G
----333-
---E3E--
-F--3---
--3F-3--
----3---
-F-FE-F-
S-------
