-------G
--E33-F-
--------
-E------
--3F-F--
-----3--
--F-3F3-
S-------
