-------G
--------
----33--
---3----
----F33-
---3--F-
---E----
S-------
