-------G
--E-----
--3-----
---F--3-
------F-
----3-3-
-3--3-3-
S-------
