-------G
---3----
-F-333--
---F3---
-----3--
------E-
-E--F---
S-------
