-------G
----3E--
------E-
--3333F-
---E3F--
--3-33--
------F-
S-------
