-------G
--------
--3F-33-
---3--3-
-----3--
-F----3-
---F----
S-------
