-------G
--3-----
---3----
--------
---F33--
-3------
-3F-----
S-------
