-------G
-F------
-333-F--
-F-3----
--------
-F--F3--
-3--3---
S-------
