-------G
-3------
-3EF----
-3--3---
----E-3-
-----3--
--------
S-------
