-------G
--------
---33F--
-3-F-F3-
---3----
--3-3---
-F-E----
S-------
