-------G
-FF3----
---F33--
-3------
--------
------3-
--3-----
S-------
