-------G
---33F--
----33--
-33-E---
--------
---F3-E-
--3-3F--
S-------
