-------G
--------
--F--F--
-3--3---
--------
----3---
--33----
S-------
