-------G
--------
--F-----
-3-3-33-
-3------
------3-
--3FFE--
S-------
