-------G
---F--3-
-3------
-3----3-
-E---3--
-3------
---3E---
S-------
