-------G
---F-33-
-----3--
--3-----
-3---F--
---E3---
--3--3--
S-------
