-------G
---3-3--
---F3---
-3E3----
-F--F3--
-3-F-3--
----3---
S-------
