-------G
-3F3----
-33---F-
--F-----
--------
--3-F---
-3-3-E--
S-------
