-------G
-----33-
---3-3--
--E3F---
----3---
--3-----
-3-E----
S-------
