-------G
--------
---3----
-33-F-3-
--E-----
--33E-3-
-E3-----
S-------
