-------G
--F-3---
-333----
---3----
--F-----
--3-----
-3------
S-------
