-------G
------3-
---3----
--E-3---
--F-F33-
-----FE-
--------
S-------
