-------G
--------
-E3F----
-3--F---
-333-FE-
----E-3-
--------
S-------
