-------G
--F-3-3-
--F3----
----FF--
-3-33---
-3---3--
-----F--
S-------
