-------G
-E------
---3-33-
-----E--
-F-3----
-3-3-E--
---F--3-
S-------
