-------G
---E-3--
--3-3---
---F----
-3--F---
--F-33--
---3-3--
S-------
