-------G
-----3--
-E-3F-3-
-3---F--
-F33-3F-
--F--3--
------3-
S-------
