-------G
--3E----
---33---
--E--F--
--3---F-
----F---
---3F33-
S-------
