-------G
-F----3-
--3---3-
-----33-
--3E3-E-
----F---
-3--3-E-
S-------
