-------G
---F----
-3--3---
--3-----
----33--
--33----
-3-F--3-
S-------
