-------G
--F3FF--
--E333--
----F---
-3------
----3F--
--33----
S-------
