-------G
--3-3---
------F-
--3-----
--------
-F----F-
-3FF--3-
S-------
