-------G
--------
-3----E-
-3-3-E--
-F3---F-
-F------
--3---3-
S-------
