-------G
--F--F--
-3F-----
-----3--
--3-3FE-
--------
-F--3---
S-------
