-------G
------3-
----3---
-33-----
--3-----
---3--F-
-EF33F--
S-------
