-------G
--------
-FE3-3--
--3-3-3-
-3-33-F-
--F--F3-
---FE---
S-------
