-------G
----3---
-F---3--
---3-EF-
-----3E-
--3-3---
--F-----
S-------
