-------G
---E--F-
-----3--
-33E333-
------3-
---3----
--E-----
S-------
