-------G
--------
--3--3--
--------
-3-F-E--
-----33-
--3-----
S-------
