-------G
--3F-F--
-3------
-3E3-E--
---3FF3-
-EF--3--
----3-3-
S-------
