-------G
--3---3-
--33----
----3---
--3---3-
-F3--F--
---3----
S-------
