-------G
-----33-
--3-3-3-
--3--3--
-F---E--
-----3--
--------
S-------
