-------G
-F----3-
-3------
--3-3---
------3-
--F3-F3-
--F-----
S-------
