-------G
--FF-F--
--------
-----3--
--3F--3-
-3333F--
--3E--3-
S-------
