-------G
--------
-3-3-3F-
------3-
--E-3---
--------
--------
S-------
