-------G
-3----E-
-F---3E-
-3--3---
-3-3--E-
-3---F--
----F33-
S-------
