-------G
-3F--3E-
-3--3-E-
--3---3-
--E--3--
--------
-F-33-F-
S-------
