-------G
--------
-F33----
--3E-E--
-F--3---
--3F3---
-F-EF-3-
S-------
