-------G
-F3-----
---3----
--3--F--
--F3-E--
-----EF-
-3--E-F-
S-------
