-------G
--------
-33-----
-3------
---3-3--
-3-3F---
---E----
S-------
