-------G
-F-3----
-F3---3-
---333--
-----3--
--F--E3-
---EFF3-
S-------
