-------G
-E---33-
--333-F-
--3F-F--
--3-E-E-
--------
-F------
S-------
