-------G
---3----
-3------
-3FF--E-
----3EF-
--33F-3-
--F-----
S-------
