-------G
-----3--
-3-F----
-3F-----
-----FF-
---3E---
--3-FE--
S-------
