-------G
-FF-3-E-
-----EF-
--------
--3---3-
-33-3E--
-3--3---
S-------
