-------G
-3-33-3-
-E------
-F--3-F-
---E----
-3------
-3----3-
S-------
