-------G
-3---33-
-3-E33--
-F---3--
--------
-3----E-
----F-F-
S-------
