-------G
-3------
------F-
---F3---
-F3-33--
-EF--3F-
---E3---
S-------
