-------G
----3-F-
-33F-F--
----3E--
-33-----
----EE--
-F33--F-
S-------
