-------G
-F----3-
-3------
-3F--E--
--F3-E--
---3-3--
-3E-3---
S-------
