-------G
-E-3-33-
--------
------3-
-3--3---
--33FF--
--F--EF-
S-------
