-------G
-3--3---
-3--3-3-
--3-E-F-
--------
--3---3-
----E-3-
S-------
