-------G
----E-E-
-----33-
-3---FE-
--F-----
--3-----
-3----3-
S-------
