-------G
------F-
-F------
--F3----
--------
-3-3-3--
--3-33--
S-------
