-------G
-3------
------3-
-----3F-
-3-3-3--
----3E--
-3----3-
S-------
