-------G
--------
-E3-EF--
---3----
-3-3----
-----E--
---3-3--
S-------
