-------G
--------
----EF--
-F-33---
--3-F---
-3--3F--
-3------
S-------
