-------G
---F--3-
-3--EE--
--3-----
---E----
-3------
--3-----
S-------
