-------G
-3-EE---
---3-F--
-3E--3--
--------
-----3--
-3-F--3-
S-------
