-------G
----33--
-33-3---
--------
----33--
----3---
-E-EF-3-
S-------
