-------G
------F-
-3---3E-
-3------
-----33-
------F-
-33-----
S-------
