-------G
------3-
-F--3-3-
-3---3--
--3---3-
--FF----
--------
S-------
