-------G
-----3F-
--------
---333--
--3-----
----33--
-F---3--
S-------
