-------G
-3E-3E--
--F--3F-
-3--33--
----3---
-F-3-F--
-F-3----
S-------
