-------G
--------
-3F--F3-
----F33-
--------
-3--3---
----3---
S-------
