-------G
---E-E--
---3-3--
-3---F--
--E-----
-F---3--
-F-F-F3-
S-------
