-------G
--3-333-
----3---
--------
---3----
---FE---
--3--33-
S-------
