-------G
--------
--E--F--
-33-----
---3----
-3------
--3--3--
S-------
