-------G
---33---
-3-FEE--
--------
-----3--
-3-33---
----3-E-
S-------
