-------G
--------
-FE---F-
-3---3--
--33--3-
--3-----
-3-F--E-
S-------
