-------G
--F-333-
---F--F-
--F--3--
---3-E3-
----33--
-F3E----
S-------
