-------G
-3-E3---
---3-3F-
--------
--3---F-
-E3-----
-3--3E--
S-------
