-------G
-33F3-3-
--------
-----3--
--------
-33E----
--F-E33-
S-------
