-------G
----3-3-
--3-----
-33-----
--3-E-F-
-----3--
---FF3F-
S-------
