-------G
---33---
----E---
-----F3-
----3---
-3--3-E-
-----3E-
S-------
