-------G
----E---
--------
--F-----
----3-3-
-3---3--
----3---
S-------
