-------G
------E-
--F33-3-
--3--33-
---E----
----3-3-
------E-
S-------
