-------G
-----3--
-F-F----
--F-----
--E3-3F-
----3-3-
-33--E--
S-------
