-------G
-33-3F3-
--------
----3---
--------
--F-3---
------3-
S-------
