-------G
-F--F---
-3------
--3-E---
---3----
---F-EF-
----3E3-
S-------
