-------G
-3----E-
--E-F---
-F--F---
-F3-----
--3-33--
-----3--
S-------
