-------G
--3EF3--
----F---
-3---3--
--3--33-
-3---F--
-----3--
S-------
