-------G
---3-F--
--F--E3-
--------
--------
---F-3--
--F3-3--
S-------
