-------G
-FE-----
-EF3----
-----F--
------E-
----333-
----F33-
S-------
