-------G
-33-3-3-
-33-3---
-F----F-
---FF---
----3-E-
----EFE-
S-------
