-------G
--------
-E33----
-F------
------3-
----333-
-3F-3-3-
S-------
