-------G
--3-E---
---F----
-3-3-3--
-3E--E3-
----3-F-
----F-3-
S-------
