-------G
---3----
----F3--
--3---F-
-----E3-
-33F-33-
--------
S-------
