-------G
----F-3-
-33--3--
---3----
---3-33-
--E-----
--F--EF-
S-------
