-------G
---3--3-
-E-3----
-F-3F3--
------E-
-3-E3---
----3-3-
S-------
