-------G
---E----
-3---3--
---E-3F-
--3-3-3-
-3--3FF-
--------
S-------
