-------G
--------
-3------
-E-FF---
--E---3-
---3----
-3-3----
S-------
