-------G
---F----
-3E--3F-
-3-33-E-
-3------
--F-----
---3--3-
S-------
