-------G
-----3--
--F--F--
-3-E--3-
-FE3----
-E-3----
--------
S-------
