-------G
---F-3--
---3E---
------3-
--3--3--
-E--3---
-33--F3-
S-------
