-------G
---3F---
------3-
------E-
--3--3F-
-F33--F-
--3-3-E-
S-------
