-------G
-33---F-
---33EF-
----F---
--E---3-
----3---
--------
S-------
