-------G
-3-E3---
-----F--
--3F----
-E------
--3-3F--
-3-3-F--
S-------
