-------G
----3---
--3-33--
----33--
--EFF---
----FF--
---3-3--
S-------
