-------G
-3-E3-F-
-----3--
-3--3---
------3-
-3------
-3----3-
S-------
