-------G
--3F----
--3F3---
-E----E-
----3---
---F3-3-
--------
S-------
