-------G
--3-F---
-----33-
-----3F-
------E-
-----EE-
-3------
S-------
