-------G
-33-----
-E-E----
-----3--
-3-F-3--
----3---
-3--E---
S-------
