-------G
-F------
-333----
--F-----
--E---F-
--3-----
------3-
S-------
