-------G
---EF---
-33-E---
------E-
-F---3--
-----3--
-3--3---
S-------
