-------G
---3----
---3----
----3---
---E----
-3-3----
---EFE--
S-------
