-------G
-3------
----F---
-F-3--3-
--------
--3-33F-
--------
S-------
