-------G
-F3--F--
---3-E--
-3FF3---
---33---
-----3E-
--E--3--
S-------
