-------G
---3----
------3-
---E3-F-
--F3--3-
---3-E--
-F-EFF--
S-------
