-------G
-33F--3-
-3----3-
--3E-3--
-F------
------E-
--3-----
S-------
