-------G
-33-----
-3--E3--
---FF---
--3-E---
-33F3---
---3-E--
S-------
