-------G
--3F----
--E-3F--
---EFF--
-F--3E--
--------
-3-3----
S-------
