-------G
---FF---
--------
-FE--3--
-33-3-3-
-----33-
--3-E---
S-------
