-------G
-F------
---3-E3-
------3-
-3--E-3-
--------
--------
S-------
