-------G
----3---
--F-F---
--3--F3-
---3-3--
-F------
---33F--
S-------
