-------G
----3---
--EF----
-3----F-
-F3-----
--3--33-
-E-E----
S-------
