-------G
-3------
-3------
-E--FE3-
--------
-3-3----
--3-----
S-------
