-------G
--EF----
--33----
----3---
--33----
---F-33-
------3-
S-------
