-------G
---F-3--
-----3F-
-F-33---
-F---3F-
--------
-33--3--
S-------
