-------G
--3-----
-----F3-
----F---
---3E3--
---FF---
------3-
S-------
