-------G
----33--
-F------
--3---3-
----3-F-
---F-E3-
---3----
S-------
