-------G
-3--EF--
----F---
-E---33-
-F-3----
--33-FE-
--------
S-------
