-------G
-----E3-
-3----F-
-33--3--
---3----
--3-----
---33---
S-------
