-------G
--333F--
--33F-E-
----F-3-
-----3--
----33--
---F--F-
S-------
