-------G
-3--3---
--3-----
--------
--33E3--
-F-3-33-
--------
S-------
