-------G
---F----
-----3--
---F--3-
-3-333--
--------
--3-E3E-
S-------
