-------G
--FF--3-
-E--3---
-----3--
----E-3-
-F--F---
----E3--
S-------
