-------G
-----E3-
-----E--
---F-F--
-3---33-
-3-3F3F-
-E-F-3--
S-------
