-------G
-3-3-E--
-3F-FFE-
---3F3--
------3-
------F-
---E33--
S-------
