-------G
--3-3-E-
---E3-3-
-F-F-F--
----3---
-----3--
-3F--F--
S-------
