-------G
-----F3-
-F3-----
-3--F---
----3---
--F3-3--
----3---
S-------
