-------G
------E-
--3-3E3-
--3--E--
-F------
-F33--3-
---3F3--
S-------
