-------G
-3---EF-
--F-3-3-
--F--3--
--3--E--
-3--E---
----F33-
S-------
