-------G
------3-
-3------
-3------
---F3---
-----33-
-----F--
S-------
