-------G
-E--F3--
----FE3-
-----33-
--------
--33----
-F-3-F--
S-------
