-------G
-----3--
--3FF3E-
--------
---3E---
---3-3--
-E---3--
S-------
