-------G
-----3--
--------
---3----
--------
-F-3-F3-
--3F-3--
S-------
