-------G
-F---E3-
-F------
--3-3-3-
-F-3----
-3------
---3-3--
S-------
