-------G
--------
---3E3F-
-----E--
-E3-3F--
-3F-----
--------
S-------
