-------G
-F-3-F3-
-E----F-
--3-E-F-
---3--F-
-3--3-3-
-----33-
S-------
