-------G
--------
--E--33-
-----3F-
--F-F33-
-FF333--
---3----
S-------
