-------G
--3-FE3-
--FF----
--E-----
---333--
--E-----
-3----3-
S-------
