-------G
-----F3-
--33-3--
----3-3-
-F------
-F--33F-
-F------
S-------
