-------G
--E-3---
-----F3-
-3F-----
--3--3--
----F---
--E-3F3-
S-------
