-------G
-F3-E---
---3----
----3---
--33----
---F--F-
-F---3--
S-------
