-------G
--------
---3-33-
------3-
--------
-----3--
--3---F-
S-------
