-------G
--333---
------3-
----FF3-
---3--3-
---3----
-----3--
S-------
