-------G
------E-
--3-----
-E---F--
--------
-3E---3-
--F--33-
S-------
