-------G
-E3--F--
--3F----
---3F---
-3---3--
------3-
-----3--
S-------
