-------G
----33F-
--3-----
---F3F--
--3---3-
-3E33E--
---F----
S-------
