-------G
-----33-
---3----
-3F-----
---33---
----3---
--3-----
S-------
