-------G
-----3--
--F-E-F-
-F3--3--
--3--3--
----3---
-3-F-E--
S-------
