-------G
--------
----3-3-
-E-F----
-3------
-F--3---
-3-3F3--
S-------
