-------G
-3-F--3-
----FE--
--3F-F--
-3--3---
-F3E3-3-
-3------
S-------
