-------G
-F------
---3----
----E33-
-E------
-E3-----
-----3--
S-------
