-------G
--------
-3-3----
-E---E--
--F-3---
-3-FE3--
-F----F-
S-------
