-------G
--FF----
------3-
---33---
-3------
---33-3-
-E--F---
S-------
