-------G
-F-E-F--
------3-
-----E--
----333-
--E3F-F-
---F----
S-------
