-------G
--EFE33-
-F----3-
-33FF---
-3--F---
-3------
-3-3--E-
S-------
