-------G
---E----
----EF3-
----F---
-3--3---
--3-----
--3-----
S-------
