-------G
-3E3F---
-E3-FF--
-3-3F-3-
--EF-3--
-----3--
-----3--
S-------
