-------G
---3----
-F-FF---
-F--F3--
----33--
--3-3-3-
-3--3---
S-------
