-------G
---3-3--
---3--F-
--3FF---
--33-F--
-----E3-
----33--
S-------
