-------G
-3FF--F-
-3--E---
--3-F---
-3------
----E3--
-E-3----
S-------
