-------G
---3----
--F---3-
-E-FFE--
-3----3-
---E----
-3---F3-
S-------
