-------G
-3-3F-3-
-EF3-3E-
--3-33--
--------
--F-----
-F------
S-------
