-------G
------3-
-E--F---
--F-----
-33-33--
--------
-----E--
S-------
