-------G
------3-
--F-----
-3-F--3-
---EE-3-
--F-F---
--F3-33-
S-------
