-------G
----F-3-
-FF-----
-33---3-
----3---
-E--33--
-3-3F---
S-------
