-------G
-E-3----
-E3--33-
-F------
-3---3--
-F--E---
------3-
S-------
