-------G
-FF-----
-----F--
-33---F-
-----E--
-3----3-
--3-3F3-
S-------
