-------G
-F-3----
--3-----
--FF3---
-3-3--3-
-3E-3---
----E-3-
S-------
