-------G
------F-
--3F----
--33----
---3-3--
-3E--33-
--------
S-------
