-------G
-3--33--
---3--3-
-----3E-
--------
-F---3--
---33---
S-------
