-------G
-----3E-
--3---3-
-3--33--
----3F--
----E---
------3-
S-------
