-------G
-3--E-F-
-3--3---
------E-
-----F3-
--------
-E--F-3-
S-------
