-------G
--------
-3FF33--
----3E--
-3----3-
--E---F-
-3F-----
S-------
