-------G
--F-3-3-
-E-E--3-
-3------
--3-----
--333F--
--3--E--
S-------
