-------G
----33--
-----F--
-3---F3-
-3-3----
--3-----
-----F--
S-------
