-------G
-F--E---
----E---
--33--E-
-3-F-F--
-3---F--
--3--3--
S-------
