-------G
--3-----
----3-3-
------3-
-----F--
-FF--3--
-3--E-3-
S-------
