-------G
-----33-
--------
--F3----
-F333---
--------
-3----F-
S-------
