-------G
--------
----3-3-
--3F--F-
---3----
-33F----
--3F-3--
S-------
