-------G
-3----3-
----E---
-F----3-
----333-
-E--E---
--------
S-------
