-------G
---F3-3-
-3F3----
--F3-EE-
-----33-
-----3--
--3--F--
S-------
