-------G
-33-----
---3----
--------
--E-33--
-----F--
-F------
S-------
