-------G
---EF3--
-F-E--F-
--3-----
-3-F3---
----333-
-E-F----
S-------
