-------G
-F---E3-
---33-E-
----3---
----33--
---E----
---33---
S-------
