-------G
-333----
---3----
-3-FFEE-
-3-3----
---3----
---3----
S-------
