-------G
-----E--
---33---
-3---3--
------3-
-----33-
--E3--F-
S-------
