-------G
-E---3--
--3---3-
--3---3-
--33-3--
-----F--
--------
S-------
