-------G
-33-3---
--------
--3--33-
------3-
-3-F3---
-E---F--
S-------
