-------G
---3----
---F-33-
-E--33--
----3---
----E-E-
-F--3-F-
S-------
