-------G
---3--3-
----F-F-
--------
-3------
-33-3-3-
--3-----
S-------
