-------G
--33--3-
--E-----
-----3--
---F----
--3-----
-3------
S-------
