-------G
----3---
--FE-33-
--3---E-
--------
-F-3--3-
---3--F-
S-------
