-------G
--3-F---
-E--33--
--------
-----3--
-E---33-
--------
S-------
