-------G
-33--E--
--------
--------
----FE--
--F3F-3-
--3-3---
S-------
