-------G
--F---3-
---3--F-
-F------
--------
--3---3-
---3E-F-
S-------
