-------G
----3---
-3-3-E--
-3------
--F3----
----F---
-E---3F-
S-------
