-------G
-----3E-
-E------
---3----
-333--3-
--FF----
---3-FE-
S-------
