-------G
---33---
--F-----
--F-----
----3---
----3-3-
--3-----
S-------
