-------G
-F--3-F-
-----F--
---33---
-F-3----
------3-
---3----
S-------
