-------G
------3-
-3-33---
--E---F-
--3--3--
--E---F-
-F------
S-------
