-------G
-3------
--------
-3------
--3EF---
---333--
--------
S-------
