-------G
---F----
--------
-3------
--F---F-
---E3E--
--3F-33-
S-------
