-------G
-E-3-F--
-F3-3F3-
----3---
----3---
-3------
------F-
S-------
