-------G
--------
---F----
--3--F3-
----3F--
--3E3---
-3------
S-------
