-------G
--F3-F--
---3--F-
---3--E-
-E---3--
-3----F-
--3---E-
S-------
