-------G
---3F-3-
--------
-E--333-
-3------
-F---E3-
-3--F---
S-------
