-------G
---3FE--
-3F-3F--
--------
--------
-33-33--
----F33-
S-------
