-------G
---E----
--3-----
---3----
--3-33--
-33-3---
----E-F-
S-------
