-------G
-F-3-33-
--------
--FE3---
-----F3-
-----3--
-----3--
S-------
