-------G
------F-
-F---F--
-3------
----F-E-
-33-F-3-
--3E----
S-------
