-------G
---3-F--
--F3----
-E----F-
------3-
-3---3--
--------
S-------
