-------G
-----3F-
------3-
---3----
-3-E--3-
--------
-3------
S-------
