-------G
-E33E---
---3--F-
-33-F---
--------
--F-----
--33--E-
S-------
