-------G
-F--3F--
----F---
-3-EE---
-3--E-F-
--------
-----33-
S-------
