-------G
--F-E---
-----F3-
--33--3-
-F---3F-
---3-3--
-3---3--
S-------
