-------G
-3E33---
-E3---E-
--3-33--
-3--F---
---3F---
--F-----
S-------
