-------G
-F---33-
-----F--
--------
-----3F-
---3--3-
-F3---F-
S-------
