-------G
--3E-33-
--3-----
---33-3-
--------
---3-F--
-F-F-3--
S-------
