-------G
------E-
--------
---333--
-3-F3---
--------
--------
S-------
