-------G
-F------
-3---3E-
--3-----
--E--33-
--3E-3--
----F---
S-------
