-------G
-3-F--3-
------3-
---F----
---F----
-3-3-3--
-----3--
S-------
