-------G
-3-F----
----3---
--3-3---
-3E3-3F-
--3-F-3-
-F--F---
S-------
