-------G
--------
--3-3---
-33--3E-
---F3-3-
-3----F-
----F---
S-------
