-------G
--FE333-
-----FE-
---3--F-
--FE-3--
-3-3----
---3----
S-------
