-------G
-F3-3---
----FF--
------F-
--33-3--
--------
---F----
S-------
