-------G
-----3--
--F-----
-FF-33--
-F3-----
--33-F--
----33--
S-------
