-------G
--------
-3F-F---
--3---F-
---F3---
--E--3--
---3-3--
S-------
