-------G
--E-33--
-E------
-33-----
--333-3-
--EF3---
--------
S-------
