-------G
-3--3---
---EEF--
--------
--F-3---
-3--E3--
--3---3-
S-------
