-------G
--E--3--
--3-----
----3-3-
-33--3--
---3-F--
----3E--
S-------
