-------G
-FF---3-
-3E-----
---F3---
-F----3-
-----F--
-----33-
S-------
