-------G
----3---
--EF3-3-
--3F-F--
-3----3-
-F--E-3-
---EF---
S-------
