-------G
-----33-
--33-33-
---3----
------E-
--F-FE--
---E----
S-------
