-------G
-3-F3---
---3--F-
--3--F3-
---F-3--
---33-E-
------F-
S-------
