-------G
-3F-3-3-
---3----
--33----
----3---
-F------
-E-F-3--
S-------
