-------G
-F---F--
--3---3-
---33---
----F-3-
-3-3--3-
----F---
S-------
