-------G
-33-3---
---F----
---3----
--33--3-
--3-----
---F-F3-
S-------
