-------G
-----EE-
-3------
-3FF3-3-
----3---
-----F--
-E-3-F3-
S-------
