-------G
-FE-3---
----3---
-3F--3--
--333---
------3-
---3----
S-------
