-------G
-----F3-
----3---
-E------
----F-3-
-3--E-3-
--3F----
S-------
