-------G
--3--F--
-E------
--E-----
----F3--
--F-3---
--F3--3-
S-------
