-------G
-----EF-
--FE-F--
-33---3-
-3--3-3-
-3-F3-E-
-3---F--
S-------
