-------G
--------
----FE--
-F---3--
-3F33-F-
--------
----3---
S-------
