-------G
-F-F--3-
-3---E3-
--E--33-
--3E3-F-
-F------
----3---
S-------
