-------G
--------
-F--3---
-3--3---
--------
--------
--F33-F-
S-------
