-------G
--3-----
--3-3-F-
--------
--3---3-
---E-E--
-F333---
S-------
