-------G
-3FE3-F-
-3----3-
-3------
----3---
-----33-
-----3--
S-------
