-------G
--33--3-
--F-----
---F3---
-E-3-E3-
--3F----
-F---F--
S-------
