-------G
-3-3-33-
--------
-E-3E-3-
--F-----
--E-3-3-
--------
S-------
