-------G
------3-
--FF-F--
------3-
----3---
-F----3-
------3-
S-------
