-------G
-3----F-
-3--F---
----3E--
------3-
-----3--
----3---
S-------
