-------G
-F--E---
--E3E---
-FF--33-
--------
--------
---3-F3-
S-------
