-------G
-3--3-F-
---33F--
-EF---3-
----3---
-----33-
----F-F-
S-------
