-------G
--E-333-
--------
-----F--
-F3-----
-F--F---
---3----
S-------
