-------G
-3F3-E--
--3-3F--
-----EF-
---E-F--
-----3--
----F---
S-------
