-------G
--F--3--
--------
--E---3-
-3-F-3--
--FF--E-
-3-E----
S-------
