-------G
--333E--
----F---
-3------
--E-33--
-3---3--
--3-----
S-------
