-------G
--F-----
-----F--
-33-----
----F-F-
----3-3-
--3E----
S-------
