-------G
-F--E3--
-F3-----
----E---
-F-F33--
--3--3--
---F----
S-------
