-------G
--------
--33--3-
-----33-
-3---F3-
---3FF3-
--------
S-------
