-------G
--33-E--
-3------
--E3-3--
-F---3--
-3F-F---
-3------
S-------
