-------G
-3--3---
-F----3-
--F-3---
--3-----
---E3---
-----3--
S-------
