-------G
--33--3-
-F------
----F---
-----3--
----F---
----3E--
S-------
