-------G
-3----F-
-----E--
--3-3---
--------
-3--3---
--------
S-------
