-------G
-----FF-
------F-
--E-----
-3F-3-F-
-3-3-3--
---E-3--
S-------
