-------G
-3--F---
-----3F-
-F3-----
---3----
--E--F--
---3-F--
S-------
