-------G
-----3--
--3F----
----33--
--------
--------
--3-----
S-------
