-------G
--F-3F--
--3F33--
-3------
------3-
----E---
--3-33--
S-------
