-------G
---3--3-
--------
--3E----
-3-F----
--3---F-
----F33-
S-------
