-------G
-3------
--3--F--
---3E---
--E3----
--3-3-3-
---E-33-
S-------
