-------G
---3-3--
-----E--
---F-E3-
-3-3----
---3--3-
---F----
S-------
