-------G
--F-F-3-
-----33-
-EE--3--
--F-3-3-
-33E----
--F-F---
S-------
