-------G
-3-3F3--
--------
-EE-3-3-
-----33-
-3----F-
--------
S-------
