-------G
-F-3F3--
----F---
---33F--
-3---3--
---F----
-33E--3-
S-------
