-------G
--3F333-
--3F-3--
--3--3--
--------
--------
-3---FF-
S-------
