-------G
--------
-----33-
--F-3---
----3---
----3---
--3-----
S-------
