-------G
---E-FE-
-33-3---
--------
--3E3-3-
-----3--
---3--F-
S-------
