-------G
----3-E-
-3---3--
----FF--
---E33--
--------
----3F--
S-------
