-------G
----3-3-
---F-E--
-----E--
--F3-3--
--------
-F---3F-
S-------
