-------G
---3----
-F3E-F--
-----3E-
--------
--F---3-
-3--F---
S-------
