-------G
--3-----
----E-3-
-----E--
------F-
-F-F----
-3-3--3-
S-------
