-------G
------3-
-----F--
-E-3--F-
-----E--
-F3-----
-3--3---
S-------
