-------G
-3----3-
-E3-----
--3-3-3-
--3E--3-
-FE-----
---F----
S-------
