-------G
---3-3F-
-F---3--
-E333---
-F--3-3-
---3-E--
-E------
S-------
