-------G
-3------
-3-3--F-
----F3--
--3-----
---3----
--FF-F--
S-------
