-------G
----F---
------3-
----3---
----F---
---3--3-
--FF3F--
S-------
