-------G
--3-F---
--3-3---
--------
--F-3---
-3F-----
---F-F3-
S-------
