-------G
--33--F-
-----E--
--3-----
--33-3--
-33-----
--------
S-------
