-------G
--------
-F3E--E-
-3------
-3F-----
----3---
-E-3----
S-------
