-------G
-3----E-
-333----
-333----
-----F--
-3--E-E-
--3F-F--
S-------
