-------G
-----3--
-3--3-E-
------F-
-E------
-F-F-33-
-333F---
S-------
