-------G
--3--3E-
-3-3----
---FF-E-
-33-----
--------
---3----
S-------
