-------G
---F3F--
--------
-33---3-
--3-F---
-3FF-E--
---3-E--
S-------
