-------G
--3-E---
-3------
------F-
-33-----
---333--
--E--3--
S-------
