-------G
-3E--F3-
---F-F--
---FE-3-
-3------
-----3--
--------
S-------
