-------G
-3------
---F-EE-
-3----F-
--333---
---33---
---3--F-
S-------
