-------G
--------
--3--E3-
--F-3---
--33----
-3F33-3-
----E---
S-------
