-------G
--3-----
---3----
--------
--E-F---
-3--3FE-
---FE3--
S-------
