-------G
--3-----
----F3--
---3----
--------
---FFF--
---33---
S-------
