-------G
-F-3----
---3E3--
----3---
-----3--
-F---3--
--------
S-------
