-------G
-3------
---E3E--
------E-
--F33---
----33--
---3-33-
S-------
