-------G
-33-----
---3F---
----33E-
-3--E3--
--3-----
--E---3-
S-------
