-------G
----3FE-
---F-F3-
-3F-----
--F---E-
---3-3--
-E3-----
S-------
