-------G
---F-3--
-F-3-3F-
-3--F-E-
------3-
-E---33-
--------
S-------
