-------G
-E--F3--
-E----3-
--F-33--
-33F3-3-
-----3F-
-----F--
S-------
