-------G
-F33----
--F---F-
---F----
------3-
-3---F--
-----3--
S-------
