-------G
-E--F-F-
---F----
----3---
--E-----
--33----
-333----
S-------
