-------G
--3---E-
-3F--F--
-33-----
---3E---
-3-3-3E-
--F---3-
S-------
