-------G
------3-
------3-
-3------
--3---E-
-3-3E---
--F---E-
S-------
