-------G
-3-3-33-
-3-3----
-3------
---EF---
-3-F3---
-E----E-
S-------
