-------G
--F-E-3-
--F-F---
--------
--F-3-3-
-3-F3---
--3-E-3-
S-------
