-------G
-EF3-3--
-F-F----
--3--3--
--3-----
----3-E-
---F-E--
S-------
