-------G
-----3--
---3--3-
---3-FF-
----3E3-
-F3-----
-3-3----
S-------
