-------G
---F----
---3-F3-
----3---
-33-----
-----F3-
--3--F3-
S-------
