-------G
-3-E33--
----F3--
--3---3-
----3---
---3----
-3------
S-------
