-------G
------3-
----3-F-
-----F--
---33-F-
--F-----
-3------
S-------
