-------G
-33F----
--------
---FF-3-
-3--3-3-
-----F3-
--3---3-
S-------
