-------G
-E-F-3--
----F3--
-----3F-
-3--F---
--F-333-
--3-3EE-
S-------
