-------G
-3------
---F-33-
-3-F----
--------
----3E3-
-----E--
S-------
