-------G
--------
--33----
-3--F-3-
-EEFF---
--F-----
----F-3-
S-------
