-------G
----3-3-
--------
-F--F3--
--E3--3-
---3-3--
----33--
S-------
