-------G
-----3--
-FE33---
----33E-
-F--3---
---3--F-
----F---
S-------
