-------G
-F----3-
--F33-F-
----E-3-
-3--EF--
---F3---
---33---
S-------
