-------G
-33-3-3-
--F---3-
----F---
------F-
-E-3F---
----33--
S-------
