-------G
-----3--
--------
---E--3-
--E-----
--E---3-
-F-33-3-
S-------
