-------G
----3---
-3F--3F-
--3--F--
----EE--
----E-3-
----F-F-
S-------
