-------G
---E----
---E3---
-3---FF-
-3FF-F--
---3----
---3----
S-------
