-------G
-----F3-
---3----
----3-F-
------F-
---3-3F-
-F---3--
S-------
