-------G
------3-
-3E---F-
--33-3--
-3333---
--------
--F-----
S-------
