-------G
---33F--
---333--
-----F--
---3E---
-F-E3---
-3F-----
S-------
