-------G
----E---
--------
---3----
-----33-
-E----F-
--3F--3-
S-------
