-------G
---33---
-333----
-F-3----
--FF3-3-
----F---
--3-----
S-------
