-------G
--------
--33F3--
------F-
-F3---F-
---3----
--E3----
S-------
