-------G
--------
-3-3--3-
--F-E-E-
-FFF----
--E--F--
--33-3--
S-------
