-------G
--F3----
------3-
-3F-----
-F-3E-3-
--F-----
---F3---
S-------
