-------G
-3--3---
-3---FF-
--------
-3--F---
----3---
-E----3-
S-------
