-------G
---3--E-
--33----
-E----3-
----F---
-EF3----
-3------
S-------
