-------G
--3-F3E-
-3------
-3E-FF--
-3-F----
--------
--------
S-------
