-------G
-F---F--
----3---
--3E3F--
----EE3-
-F3--3--
-3---F--
S-------
