-------G
---3-3--
-----F--
------3-
-3F-FE--
--------
-F3-F3--
S-------
