-------G
---E--3-
-3--3F--
----E3--
--F-3FF-
--F3----
---33-E-
S-------
