-------G
-F------
--33--3-
-E-E3---
---E-3--
--------
-----F--
S-------
