-------G
-----E--
---333--
---3EE--
-F-F-3--
-3------
-33-3---
S-------
