-------G
-3------
--F33-F-
--F-3---
----F---
-E----E-
----3-3-
S-------
