-------G
-3-F3---
-3F3-F--
------3-
--------
----3---
----F-F-
S-------
