-------G
-3-3--E-
-----E--
------F-
--F-3---
-33-3F3-
--3F----
S-------
