-------G
--3---E-
-3E3----
------3-
------3-
--E3-F--
--------
S-------
