-------G
--33----
---3FF--
--E-F-3-
---F----
-3---F--
-E------
S-------
