-------G
----3-3-
---3EEF-
-3--E-3-
---F3---
----3---
------F-
S-------
