-------G
---33---
-----F--
------3-
--3F----
-3--EF--
--F-----
S-------
