-------G
--3--F--
---FF---
-33-----
-----3--
---3----
--------
S-------
