-------G
----3---
--3---F-
---33---
---FF---
---3--3-
----F3F-
S-------
