-------G
--33-33-
-F---F--
--F3--F-
--------
----3E--
-33--3--
S-------
