-------G
----3---
-F3-E---
---3-3--
-----F3-
-3------
---3--F-
S-------
