-------G
-3--F---
----3---
-----3--
----3-3-
-F-3-FF-
--33----
S-------
