-------G
----33--
--3-----
-F-33E--
--------
-33-3F--
-3FF-F--
S-------
