-------G
--F-----
--3-----
--3-----
--------
-3FF3-F-
-F3-E3--
S-------
