-------G
--------
-3---FF-
-E-3--3-
-3-3F-E-
----FF--
-3---3--
S-------
