-------G
--------
----3-F-
--F3----
-33E3---
-----3--
--E--33-
S-------
