-------G
-----F--
-F-3E---
----33--
---333--
---3--3-
---3----
S-------
