-------G
----33--
--------
----3---
---33---
--------
--FE--3-
S-------
