-------G
--------
-333--3-
-F--3---
---E----
--------
---F3---
S-------
