-------G
-33---F-
-F------
-33-----
--3-----
-3F-3---
-3F--3F-
S-------
