-------G
--------
-3---3--
-3F33-E-
---E-EF-
-F------
--3---3-
S-------
