-------G
-----3E-
-E33F---
-----3--
--------
-F----3-
---E3---
S-------
