-------G
--3-33--
---3----
---F--3-
------E-
--E--F--
-F333E--
S-------
