-------G
--3--33-
--------
--F-----
-3--33--
-3-E-3--
-----3E-
S-------
