-------G
--------
-----3--
--------
-3-F--3-
---3F---
-----3--
S-------
