-------G
--EF-33-
--------
--3E----
--F--33-
-F----E-
---33-3-
S-------
