-------G
-3E-----
-EEF-3--
-----3--
-F3--33-
--F-----
-F3---3-
S-------
