-------G
---F--3-
--3F----
-3F3-3--
--E-----
------3-
------3-
S-------
