-------G
-3333-3-
---FF---
-----3F-
-3------
----F---
--3--3--
S-------
