-------G
-3EE-3--
---3F---
--3-3-3-
-EFF----
---3-F--
--F-3---
S-------
