-------G
----33E-
-----3--
-3---3--
--F-FF--
--3-E-F-
-3--F---
S-------
