-------G
-F3---E-
--------
-3--E3--
----F33-
-3---3--
---3F-3-
S-------
