-------G
--FF----
--F33---
-F-3-3E-
----E-3-
--E-----
-33-----
S-------
