-------G
---3--F-
----3-E-
--F-3---
-3------
--3F--3-
------3-
S-------
