-------G
---E----
--3---3-
--3-F3--
--------
---F--F-
----3---
S-------
