-------G
---3----
---EF3F-
-F------
--------
-3-3----
-3-E----
S-------
