-------G
--3---F-
--E---3-
--33E33-
-F------
---3F---
----3---
S-------
