-------G
-33--E3-
----33--
---F----
--E-F---
--3--3F-
--F3EF3-
S-------
