-------G
--33FF--
-3--3-3-
------E-
--F33---
-3---3--
--------
S-------
