-------G
-----FF-
-F-3----
--3-----
-----F3-
-3---33-
--------
S-------
