-------G
------E-
--3-E-3-
--F3-F--
--3-F3--
--------
-F33F3--
S-------
