-------G
--3-3-3-
------3-
-3--33E-
--------
------E-
-3----F-
S-------
