-------G
-F------
------3-
---F----
-E3-E---
--E3--3-
--3F--F-
S-------
