-------G
-E---3--
--3-3---
--3--3--
--------
--F3E---
-3-EF---
S-------
