-------G
--3-3---
-3-3F-3-
--F-F-3-
--------
------3-
----3-3-
S-------
