-------G
---3----
--------
-E33----
----F---
-33-----
-F-3-E3-
S-------
