-------G
-F--3---
---FE3--
-F-33---
-----E--
----33--
--3--33-
S-------
