-------G
--------
-3-F----
----EF--
-3FEF---
--3-----
-3---3E-
S-------
