-------G
-3---33-
----F-3-
--E-F---
-----3--
--3-F---
--3F33--
S-------
