-------G
--3-----
----F3E-
--3F3---
--F--33-
------F-
---3F-3-
S-------
