-------G
-333----
------3-
--------
--F3----
-F--3-E-
-3-F-33-
S-------
