-------G
-3E-E-3-
----3E3-
--3---3-
-F------
---F3F--
--------
S-------
