-------G
-3-3--F-
--F3----
---3F-F-
---3-3--
-3---3F-
--------
S-------
