-------G
-3-3--3-
--FF----
-3-3----
----3-F-
----3-3-
--F---3-
S-------
