-------G
-F3--3--
-3-3----
--------
---F--3-
-F-3--3-
----33--
S-------
