-------G
--FE--3-
----F---
--3--3--
-F--3---
--3-----
-333-E3-
S-------
