-------G
-33E----
---3F---
-F3-----
--3-E---
--3--F--
-E---3--
S-------
