-------G
--F-----
-F--F-3-
--3-3E3-
-3----F-
---3-3--
-----3--
S-------
