-------G
---33-F-
-F---F--
--33E-3-
-3-FF-3-
-3------
--E-3---
S-------
