-------G
-----F--
---3--E-
------3-
-3------
--3---3-
---3----
S-------
