-------G
-3-F3-3-
-F--33--
-F--E---
---EF---
--E-333-
---F-3--
S-------
