-------G
--3-----
-333----
--E--E--
--3--F--
-E--33--
-3F-----
S-------
