-------G
-3-3----
--------
------3-
-----3--
-33-----
------F-
S-------
