-------G
------3-
--F3-3--
--------
--3F----
---3--E-
-EFE3---
S-------
