-------G
-33--33-
-3------
---E3---
---F3---
-F----3-
----3---
S-------
