-------G
-3------
--------
---F-F3-
-F------
-3------
-33-F-F-
S-------
