-------G
-3-3E-F-
-3-3----
-F----F-
-F-3-3--
-F-33---
-E--E-3-
S-------
