-------G
-E--33F-
--3---F-
---E----
---F-3--
-3---E--
--F-----
S-------
