-------G
---3----
--E3----
-----3--
--FF--3-
-E-3-FE-
--F---3-
S-------
