-------G
-3----3-
---333--
-F--E3--
-E---F--
---3--F-
-----E3-
S-------
