-------G
---33-F-
-3------
---3----
----F---
--------
---3F---
S-------
