-------G
--------
-FE-3-3-
-333F-E-
-F-F--E-
-----3F-
--------
S-------
