-------G
--33-3--
---F-F--
---3E---
-3-E--3-
--E-3---
-3------
S-------
