-------G
--F--3F-
------3-
-----33-
--------
-3--E-F-
--------
S-------
