-------G
-----E--
-3------
----3F--
--E-FF--
---FF3--
--3-3---
S-------
