-------G
-----3F-
--3-----
-----3--
-F-E--E-
--33--3-
-3E3----
S-------
