-------G
---3--3-
-E------
--3-----
-F3-3---
--EE----
----3---
S-------
