-------G
---E--3-
-3--3---
-333----
-FF3----
-F---3F-
--E-3---
S-------
