-------G
------3-
----33--
---F--3-
-E-3----
-33---F-
-3E-F---
S-------
