-------G
----F---
------F-
-3--3---
--F---E-
--3--33-
-3-3----
S-------
