-------G
----E---
--F-3-F-
-----E--
-F-F--F-
-33--33-
--3-----
S-------
