-------G
---FE-3-
----3-F-
--F--FE-
-3333---
-33F-E--
-3------
S-------
