-------G
-EE---3-
--F-----
-33-33--
---3-E--
-3----3-
-----3--
S-------
