-------G
---E--3-
--3-----
--E-3-F-
-----3--
--F3--F-
--E---F-
S-------
