-------G
-3------
---33---
-F--333-
-----3F-
--F3----
---3----
S-------
