-------G
-3--3---
---3-3--
------3-
--F---F-
---3--F-
-3------
S-------
