-------G
--33FF--
-F----E-
--------
----3---
-3---33-
-E----E-
S-------
