-------G
--F---3-
-----3--
-3--3---
-E33----
------F-
--------
S-------
