-------G
--33-E--
----3-F-
---3--3-
----F---
---3-E--
-----3--
S-------
