-------G
----3E3-
----3---
---3----
------3-
--------
-3-3F---
S-------
