-------G
-E-3-3--
-3F--3--
-FF-3---
---3-E--
-3---3F-
------F-
S-------
