-------G
--------
-----F--
--------
------3-
----333-
-33--3--
S-------
