-------G
-3-E-3--
---3EF--
-F--3---
------E-
--------
-3---3--
S-------
