-------G
------E-
-3---EF-
--3-----
--3-3-3-
----3---
----FEF-
S-------
