-------G
----33--
---F----
--------
-----3--
----E3--
--3---F-
S-------
