-------G
---3E3--
-F--33--
--3F----
--FE----
-F3--3--
-3--3---
S-------
