-------G
-3------
--3-----
--F--F--
--------
----33E-
----3---
S-------
