-------G
----FF--
---3----
-3--F3--
-3------
----3---
------E-
S-------
