-------G
---F----
-33F-3--
-----3F-
---3----
--3F3F--
----33--
S-------
