-------G
-----F--
-----3--
-3--3---
---EF-F-
-33-F3--
----E-3-
S-------
