-------G
---E----
----F-E-
--------
-3------
-3------
--F33-3-
S-------
