-------G
-E3-----
-33-3---
-E----3-
-3------
-----3--
-3F-----
S-------
