-------G
----3---
----3---
-33-F---
--------
--3-----
--------
S-------
