-------G
------F-
--33-3--
--F-3---
---F----
--------
-33F-3--
S-------
