-------G
-33---3-
--------
-F-EE-3-
--3-----
-F3-E---
--3-----
S-------
