-------G
--3333E-
--F-F33-
----F---
---F3---
------3-
---E----
S-------
