-------G
--3-33F-
--3-333-
--FF----
-----3--
--------
--------
S-------
