-------G
--E-F-3-
-3-F33--
--3-----
--F-FFE-
-3------
--E-----
S-------
