-------G
--3-E3--
----3E--
----F---
--3-E---
----F-F-
---3----
S-------
