-------G
-F--E---
--F-3-3-
-3---3--
-----3--
-33-F3--
--3--F--
S-------
