-------G
-3---3--
-3E-----
--------
---F-3E-
-33--33-
-E-3----
S-------
