-------G
--3-3---
-----3--
-3-3F-E-
--------
-3--3---
---3-E--
S-------
