-------G
---E-3--
--F-----
------EE
-F---EE-
----E--E
----FE--
S-----E-
