-------G
--E-----
-F------
-----E--
-3------
-------3
33-E3---
S--333--
