-------G
--------
-E-3--3-
--3-----
---3-3E-
-F------
-3-3----
S-------
