-------G
-3----E-
----F3--
--------
-F------
-3------
-3---3--
S-------
