-------G
-3---3--
----F3--
--FF----
----33F-
-----3--
--33F---
S-------
