-------G
--3F3---
----F-3-
--------
-----3--
-F-33---
---33---
S-------
