-------G
-3------
--E3-E--
--F---3-
--F-----
-3F-----
-----3F-
S-------
