-------G
--3-3-3-
-3-F--3-
--FF----
---E----
----3-E-
--F-3---
S-------
