-------G
---33---
--------
---3----
-3E---F-
-3------
--------
S-------
