-------G
-3--3F3-
--333-E-
---E--3-
--3---F-
----F---
---E3---
S-------
