-------G
-F3-----
-F----E-
----33--
--3-----
------3-
---3----
S-------
