-------G
--3-----
-F--3EF-
-3--F---
-----3F-
---3----
-3-3F3--
S-------
