-------G
--------
-F----3-
-3------
--FF----
----F3--
--33--3-
S-------
