-------G
--3---3-
-F---3--
-E3--F--
--F-3-3-
---33---
--3-----
S-------
