-------G
--------
--------
-3E--3--
-F3--F--
----33--
-3F-----
S-------
