-------G
-E-3----
-333----
--------
--------
--------
--3-33F-
S-------
