-------G
--3---F-
--3-----
--------
---3-3--
--EE----
------3-
S-------
