-------G
-33-----
--E---3-
----3---
-----3--
---3--E-
----F-3-
S-------
