-------G
-3-33---
-3F-----
-----3F-
---F----
-F---3E-
-F3E-3E-
S-------
