-------G
----3---
--EF--3-
--3--3--
-----3--
----E-F-
----33F-
S-------
